NO assets/brick.png
SO assets/img.png
WE assets/img2.png
EA assets/img3.png

F 127,129,130
C 49,151,214

        1111111111111111111111111
        1000000000110000000000001
        1011000001110000000000001
        10010000000000000000P0001
111111111011000001110000000000001
10000000001100000111011111P111111
11110111111111011100000010C01
11110111111111011101010010N01
11000000110101011100000010001
10000000000000001100000010001
10000000000000001101010010001
110000011101010111110111100111
11110111 1110101 101111010001
11111111 1111111 111111111111
